1111111
1110011
1100C11
1000001
100P0E1
1000001
1111111
1111111