111111111111111111
100010000C00000001
1EC0000000000000C1
10100C000000000101
10000000000CP00001
111111111111111111