11110111
10010001
10000111
1P0011E1
11111111
