111111111111111111111111111111
1000100000000000000000000000C1
100000000C00000000000000000001
10100C000000000101000000000001
10000000000C000001000000000001
111111111111111111000000000001
111000000000000000000111111111
1P0000000000000E00010000C01001
111111111111111111111111111111