111111111111111111111111111111111111111111111111111111
1P00100000000000000000000000C11111111111000000000000E1
1000000000000000000000000000011110C0000000000000000111
101000000000000101000000000001111000000000000000001111
100000000000000001000001000001100000000000000000001111
111111111111111111000001000000000000000000000000001111
111000000000000000000111111111000000000000000000001111
1C000000000000000C100000010011110000000C00000000000001
11111111111111111111111111111100000C000000111111111111
111111111111111111111111110000000000000001111111111111
111111111111111111111111111110000000111111111111111111
11111111111111111111111111111000C001111111111111111111
111111111111111111111111111111111111111111111111111111